1111111111111111111111111111111111
1ECCCCCCCCCCCCCCCCCCCCCCCCCCCCCCP1
1111111111111111111111111111111111