1111111111111111111
1000010000C00000001
1C00000P00C00000001
1C00000000C00000001
1C00000000C00000001
1C00000000C00C01001
1C00000000C00C01001
1C00111000C00C01001
1C001E1000C00C01001
1C00111000C00C01001
1111111111111111111