1111111111111111111
1000010000C00000001
1C00E00P00C00000001
1C00000000C00000001
1C0000E000C00000001
1C00000000C00C01001
1C00000000C00C01001
1C00000000C00C01001
1C00000000C00C01001
1C00000000C00C01001
1111111111111111111